
R 800 700  



NO ./textures/tan_paper.xpm        

SO       ./textures/red_stucco.xpm

WE ./textures/wool_colored_yellow.xpm



EA ./textures/wool_colored_lime.xpm



S      ./textures/tree.xpm

F     6,89,38
C      66,173,227    



            
        111111111111111111111111
        1000000000110000000000001
        1011000001110000000000001
        1001000000000002020020021
111111111011000001110000000000001
100000000011000001110111111011111
11110111111111011100000010001
11110111111111011101010010001
11000000110101011100000010001
1000000000000S001102000010001
10020202022002001101010010001
1100000111010101111101111000111
11110111 1110101 101111010001
11111111 1111111 111111111111


