
C 51,000000000000100,0
F 253,113,39

NO textures/wall_1.xpm
SO textures/wall_2.xpm

WE textures/wall_3.xpm

EA textures/wall_4.xpm

S textures/pillar.xpm
R 00000000000000001500 1004

111111111111
1000000000001
1E00020202001
1000000000001
1111111011111111
111111111111111
1000000000001
1000000000001
1111111111111

