R 1920 1000

NO textures/wall_1.xpm

SO textures/wall_2.xpm

WE textures/wall_3.xpm

EA textures/wall_4.xpm

S textures/pillar.png
F 77,39,12
C 166,171,34

1111111111111111111111111111111111111111111111111111111111111111111111111111111111111111111111111111111111
10001000000000000000000000000000000000000000000000000000000000000000000000000000000000000000000000001
10001000000000000000000000000000000000000000000000000000000000000000000000000000000000000000000000001
10001000000000000000000000000000000000000000000000000000000000000000000000000000000000000000000000001
10001000000000000000000000000000000000000000000000000000000000000000000000000000000000000000000000001
10001000000000000000000000000000000000000000000000000000000000000000000000000000000000000000000000001
10001000000000000000000000000000000000000000000000000000000000000000000000000000000000000000000000001
10001000000000000000000000000000000000000000000000000000000000000000000000000000000000000000000000001
10001000000000000000000000000000000000000000000000000000000000000000000000000000000000000000000000001
10001000000000000000000000000000000000000000000000000000000022222222222222222000000000000000000000001
100010000000000000000000000000000000000000000000000000000E0022222222222222222000000000000000000000001
10001000000000000000000000000000000000000000000000000000000002222222222222222200000000000000000000001
10001000000000000000000000000000000000000000000000000000000022222222222222222000000000000000000000001
10001000000000000000000000000000000000000000000000000000000022222222222222222000000000000000000000001
10001000000000000000000000000000000000000000000000000000000022222222222222222200000000000000000000001
10001000000000000000000000000000000000000000000000000000000022222222222222222000000000000000000000001
12001000000000000000000000000000000000000000000000000000000022222222222222222000000000000000000000001
10001000000000000000000000000000000000000000000000000000000022222222222222222000000000000000000000001
12001000000000000000000000000000000000000000000000000000000022222222222222222000000000000000000000001
10001000000000000000000000000000000000000000000000000000000022222222222222222000000000000000000000001
12001000000000000000000000000000000000000000000000000000000022222222222222222000000000000000000000001
10001000000000000000000000000000000000000000000000000000000022222222222222222000000000000000000000001
10001000000000000000000000000000000000000000000000000000000022222222222222222000000000000000000000001
12001000000000000000000000000000000000000000000000000000000022222222222222222000000000000000000000001
12001000000000000000000000000000000000000000000000000000000022222222222222222000000000000000000000001
12001000000000000000000000000000000000000000000000000000000022222222222222222000000000000000000000001
12001000000000000000000000000000000000000000000000000000000022222222222222222000000000000000000000001
12001000000000000000000000000000000000000000000000000000000022222222222222222000000000000000000000001
10001000000000000000000000000000000000000000000000000000000022222222222222222000000000000000000000001
10021000000000000000000000000000000000000000000000000000000000000000000000000000000000000000000000001
10021000000000000000000000000000000000000000000000000000000000000000000000000000000000000000000000001
10021000000000000000000000000000000000000000000000000000000000000000000000000000000000000000000000001
10021000000000000000000000000000000000000000000000000000000000000000000000000000000000000000000000001
10021000000000000000000000000000000000000000000000000000000000000000000000000000000000000000000000001
10021000000000000000000000000000000000000000000000000000000000000000000000000000000000000000000000001
10001000000000000000000000000000000000000000000000000000000000000000000000000000000000000000000000001
10001000000000000000000000000000000000000000000000000000000000000000000000000000000000000000000000001
10001000000000000000000000000000000000000000000000000000000000000000000000000000000000000000000000001
10001000000000000000000000000000000000000000000000000000000000000000000000000000000000000000000000001
10001000000000000000000000000000000000000000000000000000000000000000000000000000000000000000000000001
10001000000000000000000000000000000000000000000000000000000000000000000000000000000000000000000000001
10001000000000000000000000000000000000000000000000000000000000000000000000000000000000000000000000001
10001000000000000000000000000000000000000000000000000000000000000000000000000000000000000000000000001
10001000000000000000000000000000000000000000000000000000000000000000000000000000000000000000000000001
10001000000000000000000000000000000000000000000000000000000000000000000000000000000000000000000000001
10001000000000000000000000000000000000000000000000000000000000000000000000000000000000000000000000001
10001000000000000000000000000000000000000000000000000000000000000000000000000000000000000000000000001
10001000000000000000000000000000000000000000000000000000000000000000000000000000000000000000000000001
10001000000000000000000000000000000000000000000000000000000000000000000000000000000000000000000000001
10001000000000000000000000000000000000000000000000000000000000000000000000000000000000000000000000001
10001000000000000000000000000000000000000000000000000000000000000000000000000000000000000000000000001
10001000000000000000000000000000000000000000000000000000000000000000000000000000000000000000000000001
10001000000000000000000000000000000000000000000000000000000000000000000000000000000000000000000000001
10001000000000000000000000000000000000000000000000000000000000000000000000000000000000000000000000001
10001000000000000000000000000000000000000000000000000000000000000000000000000000000000000000000000001
10001000000000000000000000000000000000000000000000000000000000000000000000000000000000000000000000001
10001000000000000000000000000000000000000000000000000000000000000000000000000000000000000000000000001
10001000000000000000000000000000000000000000000000000000000000000000000000000000000000000000000000001
10001000000000000000000000000000000000000000000000000000000000000000000000000000000000000000000000001
10001000000000000000000000000000000000000000000000000000000000000000000000000000000000000000000000001
10001000000000000000000000000000000000000000000000000000000000000000000000000000000000000000000000001
10001000000000000000000000000000000000000000000000000000000000000000000000000000000000000000000000001
10001000000000000000000000000000000000000000000000000000000000000000000000000000000000000000000000001
10001000000000000000000000000000000000000000000000000000000000000000000000000000000000000000000000001
10001000000000000000000000000000000000000000000000000000000000000000000000000000000000000000000000001
10001000000000000000000000000000000000000000000000000000000000000000000000000000000000000000000000001
10001000000000000000000000000000000000000000000000000000000000000000000000000000000000000000000000001
10001000000000000000000000000000000000000000000000000000000000000000000000000000000000000000000000001
10001000000000000000000000000000000000000000000000000000000000000000000000000000000000000000000000001
10001000000000000000000000000000000000000000000000000000000000000000000000000000000000000000000000001
10001000000000000000000000000000000000000000000000000000000000000000000000000000000000000000000000001
10021000000000000000000000000000000000000000000000000000000000000000000000000000000000000000000000001
10021000000000000000000000000000000000000000000000000000000000000000000000000000000000000000000000001
10021000000000000000000000000000000000000000000000000000000000000000000000000000000000000000000000001
10021000000000000000000000000000000000000000000000000000000000000000000000000000000000000000000000001
10021000000000000000000000000000000000000000000000000000000000000000000000000000000000000000000000001
10021000000000000000000000000000000000000000000000000000000000000000000000000000000000000000000000001
10021000000000000000000000000000000000000000000000000000000000000000000000000000000000000000000000001
10021000000000000000000000000000000000000000000000000000000000000000000000000000000000000000000000001
10021000000000000000000000000000000000000000000000000000000000000000000000000000000000000000000000001
10021000000000000000000000000000000000000000000000000000000000000000000000000000000000000000000000001
10021000000000000000000000000000000000000000000000000000000000000000000000000000000000000000000000001
10021000000000000000000000000000000000000000000000000000000000000000000000000000000000000000000000001
10021000000000000000000000000000000000000000000000000000000000000000000000000000000000000000000000001
10021000000000000000000000000000000000000000000000000000000000000000000000000000000000000000000000001
10021000000000000000000000000000000000000000000000000000000000000000000000000000000000000000000000001
10010000000000000000000000000000000000000000000000000000000000000000000000000000000000000000000000001
10001000000000000000000000000000000000000000000000000000000000000000000000000000000000000000000000001
10001000000000000000000000000000000000000000000000000000000000000000000000000000000000000000000000001
10001000000000000000000000000000000000000000000000000000000000000000000000000000000000000000000000001
10001000000000000000000000000000000000000000000000000000000000000000000000000000000000000000000000001
10001000000000000000000000000000000000000000000000000000000000000000000000000000000000000000000000001
10001000000000000000000000000000000000000000000000000000000000000000000000000000000000000000000000001
10001000000000000000000000000000000000000000000000000000000000000000000000000000000000000000000000001
10001000000000000000000000000000000000000000000000000000000000000000000000000000000000000000000000001
10001000000000000000000000000000000000000000000000000000000000000000000000000000000000000000000000001
10001000000000000000000000000000000000000000000000000000000000000000000000000000000000000000000000001
10001000000000000000000000000000000000000000000000000000000000000000000000000000000000000000000000001
10001000000000000000000000000000000000000000000000000000000000000000000000000000000000000000000000001
1111111111111111111111111111111111111111111111111111111111111111111000111111111111111100011111111111
1111111111111111111111111111111111111111111111111111111111111111111110001111111111110001111111111111
1000000000000000000000000000000000000000000000000000000000000000000000000000000000000000000000000001
1000000000000000000000000000000000000000000000000000000000000000000000000000000000000000000000000001
1000000000000000000000000000000000000000000000000000000000000000000000000000000000000000000000000001
1000000000000000000000000000000000000000000000000000000000000000000000000000000000000000000000000001
1000000000000000000000000000000000000000000000000000000000000000000000000000000000000000000000000001
1000000000000000000000000000000000000000000000000000000000000000000000000000000000000000000000000001
1000000000000000000000000000000000000000000000000000000000000000000000000000000000000000000000000001
1000000000000000000000000000000000000000000000000000000000000000000000000000000000000000000000000001
1000000000000000000000000000000000000000000000000000000000000000000000000000000000000000000000000001
1000000000000000000000000000000000000000000000000000000000000000000000000000000000000000000000000001
1000000000000000000000000000000000000000000000000000000000000000000000000000000000000000000000000001
1000000000000000000000000000000000000000000000000000000000000000000000000000000000000000000000000001
1000000000000000000000000000000000000000000000000000000000000000000000000000000000000000000000000001
1000000000000000000000000000000000000000000000000000000000000000000000000000000000000000000000000001
1000000000000000000000000000000000000000000000000000000000000000000000000000000000000000000000000001
1000000000000000000000000000000000000000000000000000000000000000000000000000000000000000000000000001
1000000000000000000000000000000000000000000000000000000000000000000000000000000000000000000000000001
1000000000000000000000000000000000000000000000000000000000000000000000000000000000000000000000000001
1000000000000000000000000000000000000000000000000000000000000000000000000000000000000000000000000001
1000000000000000000000000000000000000000000000000000000000000000000000000000000000000000000000000001
1000000000000000000000000000000000000000000000000000000000000000000000000000000000000000000000000001
1000000000000000000000000000000000000000000000000000000000000000000000000000000000000000000000000001
1000000000000000000000000000000000000000000000000000000000000000000000000000000000000000000000000001
1000000000000000000000000000000000000000000000000000000000000000000000000000000000000000000000000001
1000000000000000000000000000000000000000000000000000000000000000000000000000000000000000000000000001
1000000000000000000000000000000000000000000000000000000000000000000000000000000000000000000000000001
1000000000000000000000000000000000000000000000000000000000000000000000000000000000000000000000000001
1000000000000000000000000000000000000000000000000000000000000000000000000000000000000000000000000001
1000000000000000000000000000000000000000000000000000000000000000000000000000000000000000000000000001
1000000000000000000000000000000000000000000000000000000000000000000000000000000000000000000000000001
1000000000000000000000000000000000000000000000000000000000000000000000000000000000000000000000000001
1000000000000000000000000000000000000000000000000000000000000000000000000000000000000000000000000001
1000000000000000000000000000000000000000000000000000000000000000000000000000000000000000000000000001
1000000000000000000000000000000000000000000000000000000000000000000000000000000000000000000000000001
1000000000000000000000000000000000000000000000000000000000000000000000000000000000000000000000000001
1000000000000000000000000000000000000000000000000000000000000000000000000000000000000000000000000001
1000000000000000000000000000000000000000000000000000000000000000000000000000000000000000000000000001
1000000000000000000000000000000000000000000000000000000000000000000000000000000000000000000000000001
1000000000000000000000000000000000000000000000000000000000000000000000000000000000000000000000000001
1000000000000000000000000000000000000000000000000000000000000000000000000000000000000000000000000001
1000000000000000000000000000000000000000000000000000000000000000000000000000000000000000000000000001
1000000000000000000000000000000000000000000000000000000000000000000000000000000000000000000000000001
1000000000000000000000000000000000000000000000000000000000000000000000000000000000000000000000000001
1000000000000000000000000000000000000000000000000000000000000000000000000000000000000000000000000001
1000000000000000000000000000000000000000000000000000000000000000000000000000000000000000000000000001
1000000000000000000000000000000000000000000000000000000000000000000000000000000000000000000000000001
1000000000000000000000000000000000000000000000000000000000000000000000000000000000000000000000000001
1000000000000000000000000000000000000000000000000000000000000000000000000000000000000000000000000001
1000000000000000000000000000000000000000000000000000000000000000000000000000000000000000000000000001
1000000000000000000000000000000000000000000000000000000000000000000000000000000000000000000000000001
1000000000000000000000000000000000000000000000000000000000000000000000000000000000000000000000000001
1000000000000000000000000000000000000000000000000000000000000000000000000000000000000000000000000001
1000000000000000000000000000000000000000000000000000000000000000000000000000000000000000000000000001
1000000000000000000000000000000000000000000000000000000000000000000000000000000000000000000000000001
1000000000000000000000000000000000000000000000000000000000000000000000000000000000000000000000000001
1000000000000000000000000000000000000000000000000000000000000000000000000000000000000000000000000001
1000000000000000000000000000000000000000000000000000000000000000000000000000000000000000000000000001
1000000000000000000000000000000000000000000000000000000000000000000000000000000000000000000000000001
1000000000000000000000000000000000000000000000000000000000000000000000000000000000000000000000000001
1000000000000000000000000000000000000000000000000000000000000000000000000000000000000000000000000001
1000000000000000000000000000000000000000000000000000000000000000000000000000000000000000000000000001
1000000000000000000000000000000000000000000000000000000000000000000000000000000000000000000000000001
1000000000000000000000000000000000000000000000000000000000000000000000000000000000000000000000000001
1000000000000000000000000000000000000000000000000000000000000000000000000000000000000000000000000001
1000000000000000000000000000000000000000000000000000000000000000000000000000000000000000000000000001
1000000000000000000000000000000000000000000000000000000000000000000000000000000000000000000000000001
1000000000000000000000000000000000000000000000000000000000000000000000000000000000000000000000000001
1000000000000000000000000000000000000000000000000000000000000000000000000000000000000000000000000001
1000000000000000000000000000000000000000000000000000000000000000000000000000000000000000000000000001
1000000000000000000000000000000000000000000000000000000000000000000000000000000000000000000000000001
1000000000000000000000000000000000000000000000000000000000000000000000000000000000000000000000000001
1000000000000000000000000000000000000000000000000000000000000000000000000000000000000000000000000001
1000000000000000000000000000000000000000000000000000000000000000000000000000000000000000000000000001
1000000000000000000000000000000000000000000000000000000000000000000000000000000000000000000000000001
1000000000000000000000000000000000000000000000000000000000000000000000000000000000000000000000000001
1000000000000000000000000000000000000000000000000000000000000000000000000000000000000000000000000001
1000000000000000000000000000000000000000000000000000000000000000000000000000000000000000000000000001
1000000000000000000000000000000000000000000000000000000000000000000000000000000000000000000000000001
1000000000000000000000000000000000000000000000000000000000000000000000000000000000000000000000000001
1000000000000000000000000000000000000000000000000000000000000000000000000000000000000000000000000001
1000000000000000000000000000000000000000000000000000000000000000000000000000000000000000000000000001
1000000000000000000000000000000000000000000000000000000000000000000000000000000000000000000000000001
1000000000000000000000000000000000000000000000000000000000000000000000000000000000000000000000000001
1000000000000000000000000000000000000000000000000000000000000000000000000000000000000000000000000001
1000000000000000000000000000000000000000000000000000000000000000000000000000000000000000000000000001
1000000000000000000000000000000000000000000000000000000000000000000000000000000000000000000000000001
1000000000000000000000000000000000000000000000000000000000000000000000000000000000000000000000000001
1000000000000000000000000000000000000000000000000000000000000000000000000111111111111111111111111111
10000000000000000000000000000000000000000000000000000000000000000000000001
10000000000000000000000000000000000000000000000000000000000000000000000001
10000000000000000000000000000000000000000000000000000000000000000000000001
10000000000000000000000000000000000000000000000000000000000000000000000001
1000000000000000000000000000000000000000000000000000000000000000000000000111111111111111111111111111
1000000000000000000000000000000000000000000000000000000000000000000000000000000000000000000000000001
1000000000000000000000000000000000000000000000000000000000000000000000000000000000000000000000000001
1000000000000000000000000000000000000000000000000000000000000000000000000000000000000000000000000001
1000000000000000000000000000000000000000000000000000000000000000000000000000000000000000000000000001
1000000000000000000000000000000000000000000000000000000000000000000000000000000000000000000000000111
1111111111111111111111111111111111111111111111111111111111111111111111111111111111111111111111111111
