R 1000 800     
NO ./textures/sky_1.xpm         

SO        ./textures/eagle.xpm

WE ./textures/bluestone.png



EA ./textures/sky_1.xpm


S       ./textures/pillar.xpm
F     74,34,34
C      10,55,140     


            

        1111111111111111111111111
        1000000000110000000000001
        1011000001110000000000001
        1001000000000002020020021
111111111011000001110000000000001
1000000000110000011101111110N1111
11110111111111011100000010001
11110111111111011101010010001
11000000110101011100000010001
10000000000000001102000010001
10020202022002001101010010001
1100000111010101111101111000111
11110111 1110101 101111010001
11111111 1111111 111111111111